11111111111111111111111111111111111111111111111111
10000000000000000000000000000000000000000000000001
10000000000000000000000000000000000000000000000001
10000000000000000200002002020000000000020020000001
10000302000020030000000000000000300200000000003001
10000000000000000000300000000000000000300000000001
10000000000300000000002000300200000000002003002001
10000000000000200200000000000000200020000000000001
10003000200000000000000000000000000000000000000001
10000200000000000000030020003002000300030002002001
10000000000000000000000000000000000002000000000001
10000000030000300000000000002000020000000000000001
10000000000000000200200000000003000000000200000201
10003002000020000002000003000000000000030000030001
10000000000000000000000000000002000000000000000001
10002000000000200300000020002000000200000000020001
10000000030000000000030000000000000000000002000201
10000000000000002000000200000020030000000000000001
10003000000003000000020000300000000000030200020001
10000020020220000000000000000000000200000000000001
10000000000000200003000000000030000000000000000001
10000000200000000000002000020000020000000000300201
10200030000030000000000000000000000000003000000001
10000000020000020000300000000003000030000002000001
10000020000000000000000003000000020000002000000001
10000000000200200300020000020000000002000000002001
10003000030000000000200000000000000000000000200001
10000002000000000020000000000030200000000030000001
10020000000000000000003000200000000300200000000001
10000000000003020000000000000000000000000200003001
10000030020000000000000200000000000020000000000201
10200000000020000003000000002000030000003002000001
10000200000000000000000000000000000000000000000001
10030200003000030020000000030000002000200000020201
10000002000000000000003020000000000000000000000001
10000000002020020000000000000003000000002000300001
10020000000000000003020000002000000000300000000201
10000030000000000000000030000000000000000020000001
10000002000300030000000000000200003020000000003001
10000200000000000200300000200002000000002000000001
10000000000020000000000200000000000000000000000001
10030000000000020000000000003000020000020000300201
10000200030000000000030002000002000003000000000001
10000000000003000020000000000000000000002020000001
10000000000000000000000000000000000000000000000001
10000000000000000000000000000000000000000000000001
10000000000000000000000000000000000000000000000001
10000000000000000000000000000000000000000000000001
10000000000000000000000000000000000000000000000001
11111111111111111111111111111111111111111111111111