11111111111111111111111111111111111111111111111111
10000000000000000000000000000000000000000000000001
10000000000000000000000000000000000000000000000001
10010011111111110000111111111111111111111111111111
10010010000000000000100000000000000000000000001001
10010010000000000000100000000000000000000000001001
10010010011111111111111111111111111111111111001001
10010010010000000000000000000000000000000000001001
10010010010000000000000000000000000000000000001001
10010010010000000000000010000111111111111111001001
10010010010000000000000010000100000000000001001001
10010010011100111111111110000100000000000001001001
10010010000000100000100000000100100000000001001001
10010010000000100000100000000100100000000001001001
10010010000000100100100111000100111111111111001001
10010010000000100100100100000000000000000000001001
10010010000000100100100100000000000000000000001001
10010010000000100100100100001111111111111111111001
10010010000000100100100100000000000000000000000001
10010010000000100100100100000000000000000000000001
10010010000000100100100100010001111111111111111111
10010010000000100100100100010000000000000000000001
10000000000000100100000100010000000000000000000001
10000000000000100100000100010000000000000000000001
11111111111111111111111111111111111111111111111111