11111111111111111111111111111111111111111111111111111111111111111111111111111111
10000000000000000000000000000000000000000000000000000000000000000000000000000001
10000000000000000000000000000000000000000000000000000000000000000020000000000001
10000000000000200000000000000000000000000000000000000200000000000000000000000001
10000000000000000000000000000000000000020000000000000000000000000000000000000001
10000000000000000020000000000000000000000000000000000000000002000000000000000001
10000000000000000000000000000000200000000000000003000000200000000000030000000001
10000000300000000000000003000000000000000002000000000000000000000000000000000001
10000000000002000000000000000000000000000000000000000000000000002000000000000001
10000000000000000000000000000000000000000000000000000000000000000000000000020001
10020000000000000000000000000000000000300000000000000000000300000000000000000001
10000000000000300000000000000000000000000000000000000000000000000000000000000001
10000000020000000000000000000000000200000000000200000020000000000000000002000001
10000000000000000000002000000300000000000000000000000000000000000200000000000001
10000000000000000000000000000000000000000000000000000000000000000000000000000001
10000030000000000000000000000000000000000020000000000000000002000000000000000001
10000000000000000000000000000000000000000000000000000000000000000000000000000001
10000000000000002000000000000000000020000000000000000000000000000000000300000001
10000000000000000000000000000000000000000000000000000030000000000000000000000001
10020000000000000000000000000000000000000000000000020000000000000020000000000001
10000000002000000000000000300002000000000300000000000000000000000000000000000001
10000000000000000000020000000000000000000000000000000000000020000000000000002001
10000000000000000000000000000000000000000000002000000000000000000000000000000001
10000300000000000000000000000000000000020000000000000000000000000000000000000001
10000000000000000300000000000000000000000000000000000002000000000000000003000001
10000000000000000000000000000000003000000000000000000000000000300000000000000001
10000000000020000000000200000000000000000000000000000000000000000000000000000001
10000000000000000000000000000000000000020000000000000000000000000000020000000001
10002000000000000000000000000002000000000000000020000000000000000000000000000001
10000000000000000000000000000000000000000003000000000020000000000000000000000001
10000000000000000000000000000000000000000000000000000000000200000000000000002001
10000000000000000020000000030000000000000000000000000000000000000003000000000001
10030000000000000000000000000000000000200000000000000030000000000000000000000001
10000000000200000000000000000000000000000000000200000000000000000000000000000001
10000000000000000000000000000002000000000000000000000000000000020000002000000001
10000000000000000000000000000000000000000020000000000000000000000000000000000001
10000000000000000000000002000000000000000000000000000000020000000000000000000001
10000000020000300000000000000000000000000000000000020000000000000000000030000001
10000000000000000000000000000000000000000000000000000000000000000000000000000001
10000000000000000000200000000000000000000000000000000000000000000000000000000001
10000000000000000000000000000000000020000003000000000000000300000002000000000001
10020000000000000000000000030000000000000000000000000020000000000000000000000001
10000000000000000000000000000000000000000000000200000000000000000000000000000001
10000000002000020000000000000000000000000000000000000000000000000000000000000001
10000000000000000000000000000000000000002000000000000000000000000000000030000001
10000000000000000000000020000002000000000000000000000000000002000000000000000001
10000003000000000000000000000000000000000000000000000020000000000002000000000001
10020000000000000003000000000000000300000000000000000000000000000000000000000001
10000000000000000000000000000000000000000000000030000000000000000000000000000001
10000000000002000000000000000000000000000000000000000000000000000000000000000001
10000000000000000000000000000002000000000200000000000000000000002000000000000001
10000000000000000000000002000000000000000000000000000000003000000000000000000001
10000000003000002000000000000000000020000000000000020000000000000000003000000001
10000000000000000000000000000000000000000000000000000000000000000000000000000001
10000000000000000000000000000000000000000000000000000000000000000000000000000001
10000000000000000000000003000000000000003000000000000000000000000000000000000001
10000000002000000002000000000002000000000000000200000020000000002000000000000001
10000000000000000000000000000000000000000000000000000000000000000000000000000001
10000000000000000000000000000000000000000000000000000000000000000000000000000001
11111111111111111111111111111111111111111111111111111111111111111111111111111111